NO ./textures/1.png
SO ./textures/lava.png
WE ./textures/lava.png
EA ./textures/lava.png
C 225,30,122
F 220,100,0

1111111111
1NP0P10001
1000000001
1M0M000001
1000001101
10TTTTTT01
1B00111101
1000100001
1B10000001
1P00000PP1
1111111111
