NO ./textures/1.png
SO ./textures/2.png
WE ./textures/2.png
EA ./textures/lava.png
C 135,206,235
F 220,100,0

1111111111
1SP0P10001
10T0000001
1M0M000001
1000001101
10TTTTTT01
1B00111101
1000100001
1B10000001
1P00000PP1
1111111111
