NO ./textures/1.png
SO ./textures/2.png
WE ./textures/1.png
EA ./textures/2.png
C 225,30,122
F 220,100,0


 11     1111111111111111111111111
         10000000001100000N0000011
11111111 11111111111111111111111
