NO ./path_to_the_north_texture
SO ./path_to_the_south_texture
WE ./path_to_the_west_texture
EA ./path_to_the_east_texture
C 225,30,122
F 220,100,0


 11    1111111111111111111111111
         100000000011000000000001
 11 1111111011000001110000000000001
1001000000000000000000001000000001
111111111011000001110000000000001
10000000001100001111011111111111
 111111111001111 11111111111111
1111011111111101   11100000010001
1111011111111101111101001000111
11000000110101011100000010001
100000110000000001100000010001
10000010000000001101010010001
11000011110101011111011110N0111
11110111 1110101 101111010001
11111111 1111111 111111111111
