NO ./textures/1.png
SO ./textures/2.png
WE ./textures/1.png
EA ./textures/2.png
C 225,30,122
F 220,100,0


 11     1111111111111111111111111
         1000000000110000000000011
 11 1111111011000001110000000000001
1001000000000000000000001000000001
111111111011000001110000000000001
10000000001100001111011111101111
 111111111001111 11111111110111
1111011111111101   11100000010001
1111011111111101111101001000111
11000000110101011100000010001
1000001100000000011P0P00010001
1000001000000000110101001M001
1100001111010101111101111BN0111
11110111 1110101 101111010001
11111111 1111111 111111111111
