NO ./path_to_the_north_texture
SO ./path_to_the_south_texture
WE ./path_to_the_west_texture
EA ./path_to_the_east_texture
C 225,30,122
F 220,100,0


 11    1111111111111111111111111
         1000000000110000000000011111111
 11 1111111011000001110000000000000000001
1001000000000000000000001000000001111111
111111111011000001110000000000001
10000000001100001111011111111111
 111111111001111 111111111111111
1111011111111101   11100000010001
11110111111111011111010010001111
11000000110101011100000010001
100000110000000001100000010001
10000010000000001101010010001
1100001111010101111101111000111
11110111 1110101 101111010N01
11111111 1111111 111111111111
