NO ./textures/1.png
SO ./textures/2.png
WE ./textures/1.png
EA ./textures/2.png
C 225,30,122
F 220,100,0

1111111111
10N0010001
1000000001
1000000001
1000001101
1000000001
1000111101
1000100001
1010000001
1000000001
1111111111
