NO ./textures/egypt.png
SO ./textures/1.png
WE ./textures/2.png
EA ./textures/2.png
C 135,206,235
F 220,100,0

1111111111
10P0P100Z1
10T0000001
1M0M0LV001
100V0N1101
10TTTTTT01
1B001DD101
100010D001
1B10000001
1L0000YPP1
1111111111
