NO ./textures/STONE3.png
SO ./textures/STONE3.png
WE ./textures/STONE2.png
EA ./textures/STONE2.png
C 135,206,235
F 220,100,0

1111111111
11000Y00W11
1111111111
