NO ./textures/egypt.png
SO ./textures/1.png
WE ./textures/2.png
EA ./textures/2.png
C 135,206,235
F 220,100,0

1111111111
10P0P10001
10T0000001
1M0M00V001
100V0N1101
10TTTTTT01
1B001DD101
1000100001
1B10000001
1P00000PP1
1111111111
