NO ./textures/egypt.png
SO ./textures/egypt.png
WE ./textures/egypt.png
EA ./textures/egypt.png
C 135,206,235
F 220,100,0


111111111111111111111
1S1010000010000000001
101011101011101010111
1T0010001000001010001
101110101110101111101
100000101010100010101
101111101011111010111
101000000010100000001
111111101110111111111
100010100000101000101
111010111011101011101
100010000000001000001
111010101111111011101
101000100000101010101
101010111111101010111
101010000000000000001
101111111011101011111
101000000010101010001
101110101010101011101
100000101000101000001
111111111111111111111
