NO ./textures/1.png
SO ./textures/2.png
WE ./textures/1.png
EA ./textures/2.png
C 200,30,122
F 200,100,0


1111111111111
1T1M10N000MM1
1010111V1M111
1M1TP00P10101
1M1B101V111B1
10V0101M1BVB1
1T101T1110101
1010100B101P1
11111011111M1
10100T1B101T1
10111M101M101
10PT00000V001
1111111111111