NO ./textures/1.png
SO ./textures/2.png
WE ./textures/1.png
EA ./textures/2.png
C 225,30,122
F 220,100,0

1111111111111111111111111111111
1000M010001V00100D0M0D10P010T01
1E11101011101110111010111V11101
10101010T00000VTB010101T0T10101
1010101110111011101111101010101
1010DDB00010P010000M00001000101
1Z101D111V111111111011101110101
10D01010B0100000101010001000B01
1110111111111110101111101110111
10101DV0P01T0P001000100B1000T01
1010101111111011111011111010101
100000100000100V1B00M0100010101
1011111111101M11101110111T11111
100T100PT010D00D001010T01000101
1011111011101110101M1V101111101
1P101000V01000101P001010M0B00V1
101011111V101011111M111T1111101
10100000101T1000P01V101B00M0101
1D111D1010111110111110101011101
1010001000101VV01B0010001010101
1P1V11111110111D1011101B1110111
10V010001000001M100P1B10P0B0001
1011111011101010111011111010101
1010P0100D001P0010001V0P1010101
1010111011101111111P10101011111
10T01B100010B010T01000101000001
1011101011101010111110111111101
1010000T101010101010000M1P0P0T1
1M1110111010111D1010111T11111D1
100T0010T0D0000010000010B0Y00L1
1111111111111111111111111111111