NO ./textures/STONE2.png
SO ./textures/STONE2.png
WE ./textures/STONE3.png
EA ./textures/STONE3.png
C 225,30,122
F 220,100,0

111111111111111111111111111111111111111111
100000000000000000000000000000000000000001
100000000000000000000000000000000000000001
1000000000000000000000N0000000000000000001
111111111111111111111111111111111111111111
