NO ./textures/1.png
SO ./textures/2.png
WE ./textures/1.png
EA ./textures/2.png
C 225,30,122
F 220,100,0

1111111111111111111111111111111
1S1000100000000P001010100010001
1D111P1111111011101T101011111T1
100010000000100010V010000000001
1011111011111111101110111110101
10V00000000B101000000M001000101
1111101111111011101011101110101
1000101000001D00001000101010101
1110101B11101010111111111010111
1010100000100010DM0010000000101
101B101111111110111010111111101
1000101000100BM0001010001010001
1011101B1110101111111P101011101
1010001010PB1010001010101BM0101
1011101011101010111011101110101
100000100M101D100000100D1000001
111M111011111111111M10111010101
10M00MV010100010M00010101010101
11111110101110111110101V1010111
1010000000V01000100010001010101
1010111111101011111010111010101
100010000010001000000B000010101
1011111011101111111110111110101
10001000001000000010000B1010P01
1111111010101110111011111011111
1000000D100000100D10001M100M001
1110111111111111111011101111101
10100D0000101010000T100010001P1
1010111011101010111010101D11101
100010000P10M00000100010000V0L1
1111111111111111111111111111111