11111111111111111111111111111111111111111111111111111111111111
11111111111111111111111111111111111111111111111111111111111111
111111110M0001111111111111111111111111111111111111111111111111
1111111100000111000T111111111000D11111111M00D00000111111111111
111111110B00P1110000111111111000011111111000000000111111111111
10000001000M01110M0010000000000B011111111000B000001100000V0011
10000M01E00P0111V000100P00000V0001111111100B0TM0001100M0D0V011
100000010000011100001000V0000000MVP0011110000D0000110000000011
1000000100000D0P0000000000000M0000000B000B00000000110000000011
1000B001111111110111100T000000000TM0B110TTV0111111110000000011
1000000111111111011110V0DBT0000000000110000V1111111100VV000011
100MB00111100M0V00001000000BB1101000V11000PB111111110000000011
100M0001111000V000001000000001101D000110V000111111000000000111
1111110000000000PB000000000000T00000111P0000111111111111111111
11111111111000000000111111101110111111100000111BD0000111111111
100P0011111B000000001111100T001011111110T00P11100000B111111111
1000001111100VM0000011111000V01011111110000P11100000D111111111
1000B0111110B000B0001111100T0M1T111111111011111000B0T1M0000111
10000P11111111M1011111111P000010111111111011111000000100000111
100M001111111100000000000P00000000000M00000000BV000T0100000111
1000001111111111011111111000001011111110M0V0000P00000100000111
100V00111111111101110000000000000000V000000000000111110000T111
1000001111100V0100000000000T0M0000000000T00000000000D000001111
111100V0P0000V00D00000M00000M000000000000000B000000D1111111111
111111111110000100000011110000000D011110M0VB000111111111111111
11111111111000010VP000111100000V0001111P00000BT111111111111111
11111000011000T100000011110BV0000001111B000000D111111111111111
111110V0011000T100T00T1111000DD0000MP000000YP00000000001111111
11111000000B111100D0001111000B0V00B111110011111110P00001111111
111110D001111111M00D0P1111111110111111110011111110000001111111
1111100001111111000M00111111111011111110P0P0000110000001111111
11111000V11111110101111111111110111111100000000110V00T01111111
1111100L0111100000MM111111M0000B00111110P0000T0110000001111111
1111100001111000B0T0111111000P000011111000D0000110M0D001111111
11111111000000000000000000000MMV0000000000000P01100D0001111111
11111111111110000000111111D00TB000111111P01111111100V001111111
111111111111100000001111111111101V111111V011111111000001111111
11111111111110000PV01111111111101011111100P0000000000001111111
1111111111111000000011111111111000000000000B00000M000T01111111
1111111000000001010111111111111010111111100PP000000111010T0011
11111111111000000D000VM01111111M1011111110000000000111V1B0B011
111100000010000000000000111111100000D0011000000000011101000011
11110000MP10000000000000100000000D0T000110M00B0000M11101B00011
1111D000001P0V00000000000000V0000V0000DB000T10000DM11101000011
11110000DM1110D0000B00000000000P00T0000B00000B011111100000P111
111111011111111B000000001000M0T00TV00001101111111111100000B111
11Z11101111111110100M00TV000D000V00000011011111111111M000T0111
111111B111111111010111111000000D000MM001101111111111100P0T0111
111110000B000V0M0000000000V0000B000000000011111111111000000111
111110B00111111111111111100000P00T00P0000011111111000000M00111
1111100001B0B0000T000T00B0P0000000000000V0111111111100P0000111
11111000010MM0B01111111111111111000000000000001111110TP00D0111
1111100001000000111111111111111100000000000000111111DD00T00111
1111100001000000111111000000000000000000000TP00000000000000111
11111BP00100T00V111111V000P011110V000000010000000P111000000111
111111111100000011111100000011111111110000000P0000111111111111
111111111100P0001111110M00001111111111111100P00000111111111111
11111111110M000011111100000M1111111111111100000000111111111111
111111111110T000B0T000D0D00P0T00M000000000000B00B0111111111111
111111111111111111111111000000000000000000B0000011111111111111
11111111111111111111000B00V000T00000000B0001111111111111111111
11111111111111111111111111111111111111111111111111111111111111
