NO ./textures/STONE2.png
SO ./textures/STONE2.png
WE ./textures/STONE3.png
EA ./textures/STONE3.png
C 225,30,122
F 220,100,0

111111111111111111111111111111111111111111
1010000000V10D111010100001010M10001D000101
100101000000010001010000001100100001000111
1T00P01000001100100000V0000000000D00000011
110000T00T0000P00000000001111011000000V1M1
1T1010100010100001000000001101000000100011
100B010T01100110011000010M01D0D1100Z10D111
1010P010000T000000010000010100000P0010P101
1000100P01010000M000M00TV1011101011001T001
10000001010P00100000V01P00010011001T000B01
10M000000000000100V0000001010101D00D0T0011
1010001000000M00000101001110B0E000000100B1
1P0100000100000000B0M00001000M100000010001
10001M0M00100000M10T1000101000000000010011
1DM10000000001110B000000TV01P10D1P000010M1
1000T00T00110000101000001000011000B001PT01
100010000000001000000001M00T010000000D0101
1000001T1001000000000L0000000001B000000001
100000M00V00PB0100110000110000001000000001
110T10M1110000110001P000100V00100000000001
100BV0010010110010000000D10P0M0010T0011001
1V1TB00001010000001000001D11100000000100V1
100000P0101001D000000010010000101M0100P001
1M0000000VT000000100100010T000000T01D00111
100T01D1T0010100010000000100110D0100010001
100000101D10001100B00000000P11010011001101
1000P001D111000000B00T10000010010000011011
1000100000000V01100000000TB0011000000T0D01
1110010V100T0V01000000P000M000B0001T000011
10000100000B10V001T00100101000000000000111
11000000B001100110000111000000010T0100Y101
101000V100000P011000110010T10011001V0D0001
1000100001000000D010M001000V1000000V111001
1010000P1010000110010001000010P00100011001
110000000D0001000110B0V0001B00V0000T100101
1001110000P011110000V0010B1110001110D1V001
1110B10100000100110001PP0000001B0101100011
111011000100100000000010110000010000P00001
1010100000100000010001110TM0010011000M0001
1010001100000000100M0T000100100V100T000M01
101000T00D000000V00V0000100001001000000111
111111111111111111111111111111111111111111