NO ./textures/STONE2.png
SO ./textures/STONE2.png
WE ./textures/STONE3.png
EA ./textures/STONE3.png
C 225,30,122
F 220,100,0

11111111111111111111111111111111
10100TVB1001D10110T001100000B101
10T1V00D000011000M000V0111110011
110M0000100000M10100100011B0D001
1100P00000111B00P1V010001B0B0101
10001V00000000000100Z1B1E0001001
1001T0000100V01MM0001001000T00P1
10101P00000B0D010010000100100V01
10T1100000000110000000B011M0D001
1001000010010M001110B1T10001V001
1V000100000100000P000V000P000001
1BD1000100B00P0M0P00010011100011
10T1100VP1100000PT01001P00000101
10001100010010001110011000100101
10V0M10100000DB000B0000000100001
101T00010BM00010001100011000P011
1011000011V1T0010000000V10100001
111000DV00M01P11V00100000010B001
1P1B00010T10P0DPM00V100000V00001
100B000100001VB000000010101P0001
100V11BM0PT10100001110011BB00011
10M0000101001V1001T1P0Y001111T01
1100000010D1M101010000010B000001
1100T1001001101000100000MM01M1V1
1000L10000000P00100001000000V001
10M100B00001001DPT00M010P0100001
11TB001000000001111011001D010D11
1V00DD1000V000011000T010B10010P1
10P1100B0T0V01VB1B10001T10010011
10000MM00000000000T1010001100D01
100000000V00000B0TT0010001000001
11111111111111111111111111111111