NO ./textures/1.png
SO ./textures/2.png
WE ./textures/1.png
EA ./textures/2.png
C 225,30,122
F 220,100,0


1111111111
100000M0P1111
 1110000M0BP1
1TTT00M0P1111
10VD00M0P1
10V0N0M0P1
1111111111
