111111111111111111111111111111111111111111111111111111111111111111111111111111111111111111111111111111
111111111111111111111111111111111111111111111111111111111111111111111111111111111111111111111111111111
111111111111111111111111111111111111111111000001111111111111111111111111111111111111110000B00000000111
111111111111111111111111000011111100000011000001111100T011100001111111111111111111111100M0000VM0000111
110000V00111111111111111P0001111110000P0110M00V1111100001110000111111111111111000000110000000000T00111
1100T0000111111111000B0100001111110M0000110000011111000M111000011100B000001111B000M0110M00000000B00111
110000M001111111110000010000111111000D0B11000D01111100001110000111000D0VD0111100000011000000000000P111
11D000B001111111110V00P1T0001111110V000011000001111100001110D0P1110000000011110000B01110111D0000T00111
11000000M111111111000T01000T111111111110110000P11111000B11100001110V000P0T11110000D0111011111111011111
110DM0000110000011000001000B111111111110110T0V011111000011110111110V0M00001111PD0000111011111111011111
110D000001100000110T00T100001111111111101111011111100B011111011111B0PM00001111000000111011111111V11111
11111110111V000P1100D0P1011D00000000000000000D0000000P0000T0000000000111111111P00000111011111111V11111
1111111011100V001111T11101111110V0P0111011110111111000D1111101111111111111111111111011101111000M000111
11111110111P000M111101110111111000D0111011110111111000011111000000T0000001111111111011101111M00D000111
111111101110DBT01111011101111110000011101111P11111100001111100000000BP00011111111110111011110M000V0111
1111111D11100M001111P000D000000000D0000V0T0D00000000000000M00000000000000000000000PV000000B0000B000111
11111110111T000011110000011111111110111P11110111111P10000000PDBB0B000T00011111111110000011111101111111
11111110111VP0B011110000011111111110111011110000000M1000V0000P0V00000111111111111110000011111101111111
1111111011111011111100000111111111101110111100000000100D0M000000D000011111111111111000T0111111B0001111
11111110111110111111000001111111111B111V1111000000001M00000000B0000D011111111111111D0000111111D0001111
111111101000000111110B00011111111110000T011100000B00100M000D01101111011111111111111T00001111110B001111
111100M000000M0111110000011111111110000000T00B0T00000000000V00000000000000000000000D000011111100001111
111100000D000PD1111100VM01111111111T0B0M01110111110T10000000T11000000001111111111110000011111100001111
1111000D00D0000111110101011111111110D000011101111100100P00B0011B0000000111111111111000001111110D001111
1111M00000M00D01B0D00101B11111111110BD000111011111D010000000011000M00001P0P000111110000011111100001111
111111001000P00100M001010111111111100DP000110111110M101110110110000T0001000000111110000V11111100001111
11111100100M000100V0010101111111111000D0V011B111110010B00011011B00M0000100D00011111V000011111100001111
11111100100P00B10000D10101111111111000000011M11111B0100000110110P0D00001000000111110000011111100111111
111111P0101110110111M1000000D0000T00000000000D00000000D0000000000000V00100VD00V000000000000D0000111111
111111001011Y0110111010V0000011111100000P011V11111001000001101100P000001111111111110000000111100111111
11000DT00P00001101110100B0000111111001111111011111001000B0110110000000011111111111100P000B11110P111111
1100000B101111110111D10000000111111001111111011111001B00D0110111111100000000000P00000000001111B0111111
110000001T111111011101M00000B111111001110P000111110010000011011111110DB0001111111110000000111100111111
1100000010P001110111D10D0000011111100111V000011111001T1100V00VMD11110000001111111110000D00111100111111
11000000100T01110111010000000111111001110000T111110010111011011111110000000000000000001D11111100111111
11000000100001110111010101110110000000DT000M0111110010111D11011111110000001111111110101011111100111111
1111100010000111011101M101110110000000000000T11111PM100000110111111101111M1111111110101D11111100111111
1111100010M00111011101010111T1100M00V00000000111110010000M11011111110111101111111110101T11111100111111
11111D0010111111T111000000VP0000T0000000P00000000000000000000000000000BV000000000000D00D0PM11100111111
111110001011111101111101T111011111100111000001111100100V0011011111110110V000P1111110000B00011100000011
111110V010111111011111010111D11111100111100T00000000P00000000B0V000P0P00M000000D0D0D00000T011100000011
11111D0V1V11111101100000000D000D000000000000000000000000000D00000000000000B00000M0P000000B0000VB000011
111110000000000D00000M00000000000M000V0V0000000000V000000000M000000000P0B00000B00000000011111100000D11
111110000VV00000011000D000000000111001100001000000DB10110011V11111000P100P0001111111100000011100000M11
1111100000M00000011000000000000011100110VP010000000010110011M1111100M0D000M0T0000P00M000M0000T00011111
11111000000V00D00111000V00B00000000000T0000M00000B000D00DB0000000000D01111111111111110000001111V111111
111110001010111101110000000D0001111TM1100B0100000P001011000BP1111100T0111111111111111MD000011110111111
11111V001010000000V00B0000000PB000000000P0M0000000V00000B00P0P00000000000000TM00T00V0T0000B000D0111111
111110D01010D000VV0000000001011111100110000101110000000000V0000B0001000T0111111110000P001111111D111111
1111100M1010000000M000T00D0100000000011M000101110M00M00000000111111100B00111111110000D0011111110111111
1111100B1010V000M0000000000D0000VB0D0000111101110000V00T000PM11111110000011111111M00V00011111110111111
1111000T00000T000000000000VB000P000000V0DD0001110000000000000000000100B00111111110000000111D0B00111111
111100000T101B1101111D01D000000000000000000000000D00V0000D00000000000D0011111111100000D011100000000011
11110000001010110111110000M1MD00000D0000000V000D000T0000V0000000000D000011111111100T000011100000000011
1111000000101011B111110D00010000D0001111000B01110000000M100M00000000T00011111111100D10101110P0P0000011
11110T00P01000000000B100000100T00000111100000111T00P0000101100000000000011110P0B000110101110000T000011
11110000T010000000D0010V0001000M00001111000001111100V0000DV0T00B0T00BT000000000000T00D1P11101110000011
1111000TPD1T00V00B0001PT00P10100000000PD000D00MP000000M00000P00011100D00111100T000011B10111M111D000011
11000000D00000000B0000P000000D000M000000000P00T0M0000P000B0DP0000M0T00P00V00D0000000M00000P0D0D0T0B011
110000M00000000001111100000101111110111111100BV0000010111011011V11100P0011110D0D00V1101T11111110000011
1100000000101011011111PP000101111110111111100000000010111011D11M111000B011110V0B000110101111111P000011
11M00000P010101DM00111010111V111111011111110000T0TBB1011101D000D0000V0000P0000000V00000000000T00000011
11111000D0101010D0011101011100000000000B000000000000000000T000M0D000000T000000T0000000DT0B111110111111
111110001T1M101000M1110101111111111011111110000000001111101101100000T001111111111111100000111110111111
1111100010101P10000111M100V0000D111011111110D00000000000000PP0MP00000M00DT000011111110000011111V111111
11111000101010100P011101000D00000V000T0000000111110111111011B11000T0000100000011111110000V111110111111
111110000010101000M11101D0000000111011000B0P0D000000000000000D0000000000000000V00000V000V00V0000111111
1111100D001010100DB1110100000000111P11B000000B1000000D1110110110M0M000010000D00M000D000001111111111111
11111000001M101101011101000000DD00000M0MV00T00P00000D0000000000D00B000D0000V00000V0D000001111111111111
11111000B0101011B10111011111111111101100000P001T000MM0111V11011M11010101B0000V1111D0000001111111111111
1111100000000D0000V00000P000000V00T0M000B000V000T000000D00000M000V0000000000000M000D000V01111111111111
11111DM01010100T01011101111100000010111111100110000MB0111B11D11B11010100000000111100000D01111111111111
111110001010100P0101110111110000001V111111110110000B00111011011011010101111111111100000001111111111111
11111000101010000101110111110T000010111111110110P0D000111D110110110101011110000011VVP00001111111111111
11111B0T1M101000010111V0000VD0000T0000000D00V0M000000011101101101101010111100000110000B001111111111111
1111100PD00000000B00000000000000T0000P000B00D0000000011110110110110101011110V0001111001011111111111111
11111000101010000101110111110000001D1111100000011101111110110110110101T111100VM01111001D11111111111111
111110001010100P01D111011111111110000000VT0M000000T0000D0P000000000000000000000000D1001011111111111111
111110001000P000000000000000V0V00D00D0000000000000000000000D0000000000000000VP111111PM1011111110000111
11111D0000B0000000000000000B0000B0000000PV000000000D00000001011D11010100000011111111001D00000110000111
1110000V00E00000000DB000BT0000000000B00000000000B0000P0000000110110101M0000011111111001000000110000111
11100000B00000000T0000000V0000000000000D00V10111110000000001111011010100VVTT11111111001000000110000111
111M0P0000000000V000000000D0B000000000VD0000D000V00000T0V000000P00000000000000000D000M10000L0110P00111
1110000MT0D0000000P01101110B0000T11000000001B111111000000001111011011100V00011111000001V00000110P0T111
11100000D00000000000110111D0T000000D00000DV00V0BT000000000000000V000000000T00P000M0000PPM0M0M0P0000111
111P00000000M01100M00000D00M00PTB00000000T0000000000B00000P0B00000000000B0000000P000001000000111111111
111000000T1110000000000000000000000M0000D0000000PT00M0000000000T000000V000V0M0D11V0000100000D111111111
11100T00M01111111111110111000000011P0000P0000T00P001111111V00V0011M11101111111111000001000000111111111
1111100M00B000000000000T0T00T00000000000000000000D0D0M00000B0T00D00000000000000000000D0000111111111111
11111P1110110TD00000V1V111V000D001100000011000000M0P00000T00000000D0000D0000000010V00P1011111111111111
111110111011D00000T0010111111111000M0000000D0000D00000000PM000P00000000000T0M0000000D11011111111111111
111110111011P000B00D00000000000000000V000V00000PD00P0M000000M0000000T0D0T0P00000000T000011111111111111
111110111011P0000D00P101111111111110000M00000000011111111100P0011101111V000000001111B11111111111111111
11P0000D0P00P000000M0M000T0M00000B00000V0000000MM11111111100000111011110000000001111011111111111111111
11P00000D00000V000000000000V0D000000000000000000000000D00M0B000000000000000000000D0PD00000111111111111
1100000011110000000V011111111111111000D00V00D00001111111111111111111111P00000V001D0000000D111111111111
1100000M111100000000011110P0000011100000DB00T00P011111111111111111111111D0111111100000000B111111111111
11111D0T00PB0000000000V0M0000000000000000V000000M0000000V0B0000D11111111111111111VB0000TV0111111111111
111111111111100000000D000000000VP00V0000000V000001111Z1111111111111111111111111111111D0011111111111111
111111111111111111111111D00000000000000000000111111111111111111111111111111111111111111111111111111111
1111111111111111111111111000P0000000000000000MT0000000000000B000D000000T00000M0PBD11111111111111111111
111111111111111111111111111111111111111111111111111111111111111111111111111111111111111111111111111111
