NO ./textures/1.png
SO ./textures/2.png
WE ./textures/1.png
EA ./textures/2.png
C 225,30,122
F 220,100,0


 11     1111111111111111111111111
         1000000000110000000000011
11111111 111111111111111111111111
1N1
11     1111111111111111111111111
         100000000011000000000011
11111111 111111111111111111111111
