NO ./textures/1.png
SO ./textures/1.png
WE ./textures/2.png
EA ./textures/2.png
C 225,30,122
F 220,100,3

111111111111111111111111111111111111111111111111111111111111111111111111111111111111111111111111111111
111111111111111111111111111111111111111111111111111000T11111111111111111111111111111111111111111111111
11111111111111111111111111111111111111111111111111100001111111111111111111111B0B0000B11111000001111111
11111111111111111111111111111111111111111111111111100M011111111111111111111110T00000011111000001111111
111111111111111111111111111110B000001111111111111110000111111111111111111000000000V0011111P0V001111111
1111111111111111111000000V0010D0D0D0111111111111111M00011111111111111111100D0DB00000011111D0M001111111
111111111000000111100000D000100000001111111111111110V00111111000001111111000000D0000011111000001111111
1111111110PV000111100000000010V0T000111111100000011000V1111110D00V1111111B0001101111111111101111111111
111111111T000P0111100D0000M0100M0T0011111110000B01111101111110D000111111100001101111111000D0V011111111
11111111100T000111100000000010D0T00011111110000001111101111110000011111110000110111111100P000011111111
1111111110000001111111000D0000DT0000111111100000P1111101111110T000111111100P01101111111000000011111111
11111111100T000111111111111111111B1110B0001000P001111101111110000T1111111P0001101111111000000011111111
11111111100D00011111111111111110B001100T001M0000011111D11B000000111111111000M11T1111111101101000001111
111111111T0P0001100000001111111000011V00B0100000P11111011000M000111111111110111011111111011D1D0D001111
1111111111011111100000VB1111111000M11V0B001111011111110110000000111111111110111011111111011010D0M01111
11111111110111111000000010P000000MT00M0MP00TV0000000BPT00000P0000000DP00000000M000M00000B0001000001111
11111111110MPV00100T00001000M00000011000M0111101000BD0011PM0000011111111M00011101111100TT000100P0T1111
11111111110P00001111111010P000M0000111110111110100000T01100000P011111111M0D011101111100000P01000001111
111111111100000M11111110100000B00001111101111101BPV0000111011T00DD0000110000111D1111100T0D001000D01111
11111111110000001111111010P00V0100B000000P0111010000BT01110110000000M01100001110111110P000001000D01111
11111111110000001111111D100000010PMT0000000111010TT00001110110000000M011000011101111100000P01000001111
111111111100000000011110100P00010000000000011101T000000111P110000B0000110000111011111D0D00001110111111
11111111110V0000000111101P0B0P01000000000V011101000BDB011101111011110111000M10000001111000T00110111111
11111111110000V0000111101100000000VV000000B00D0V00000000TP0000M0P000000000001P0D0001111101111110111111
111111111100000000011110110000D00010111101111101110111011T00000001110111111010000001000001111110111111
1111111111000000MM011110110000B0VD0000000000000011D111B1100MP00001110111111010000001V00M01111110111111
111111111100000DT0M00000000000M000000000000P000B0000000000000000000D0000000000B0000000M000000110111111
1111111000011000000T001011M10000TM00000V00000000110111011000000001110111111P111P10110TD0T1111110111111
111111100T0110BT00D0001000V0V00M001011100MP00000110111011000T00P0111000000D011101011111000111110111111
111111100001100000000T1000D00000001011100000000011011100000M000000000000000000000000000000001110111111
11111110P0M1100TBV000010000000000010111000V000001101111110000000D111000000001DVB0B0D000B00000T00000011
100000000V011MT0P00V0M1000000000001011100000000D1101111110000MTD01110000M000100V001111D00000111B0D0011
1000T00000011V00000000100000TV0000101111P11111000000000000T000PB0111000D000010000011110000B01110000011
100000MV11011110000T000000MP000D0000000P0000000000P0V0000V00000000B000M00000D00000111100V00M1110000011
100000T011011110000111100P000D0000101111011111M111000000000P000M000000000000M0000011110000001110000011
11011110000000B000011110000P00011T1M11110111110111B00000000011100P0T1B000000000000V0B00000000000000011
11011110D00000000001111011M1111110101111011111M111V0000000001110DMP01111111000000011111101101110111111
11011110T00T00000001111011011111101011110110V0B000000B000B000000M00111111100V000000000000B000000111111
1101111000V0000D00000PT0000000000000D0000000M000000V0000V0D00000000V0M000000B00000000000B0P00000111111
11011110PD00000T11111110110T0000000000M00T000V000000000000000TP0000B000000000000D0000000000B0100000011
110111101101101T1111111011111111111011110111110B00000T0000001111111111111100000000M00T0PV0000100000011
1101111011011B10111111100000D0011110111101111100M0000000000011111111111111TV0000B011111P0000010P0D0011
110111101101101011111110000M0001111D11110111110000V111111100111111111111110010111011111000000100000011
11011110110110000T0V0B1000000T01111011110111110BD0B11111110V11111111111111TD0D00B00011100M000100000011
1101111V110110000000T010000000D111101100M00011000001111111PD111111111111110000000000111B00T0010P000011
11B1111011V11V000M00001B000000000V000P00M00B000000D0B001110011111111111111P0000000001110B0P001B000B011
11D1111011011000000T001000T000D111101100PP00110000000D011000T00111111111110000000000100000001100000011
110111101101100B0000001011101111111011000P000000000B0000000000000B0P00V0000DP0000D00000000B00000V11111
110111101101101D100PV0000000000000P00000000P0000000000000000000000T00000B0P00000000000000000111T111111
1101111011T1101011111110B00000T001101100000011M11100111110P000011100V00000001B111010111001111000011111
110111101101101011111110000000D0011011VP000011M11100111110000001110000000V001011101011100111100VM11111
110111100000000V0000B0D000000000000BB0000000BD00T000000000B0000D0000P00000000000001D111BM1111000011111
1101111D0000000000B000000000000000000000V0M00T0000T0000000P00000000000T000000000000B001P01111000011111
11011111000000000D00B110000000000110111101100T000000V00VT000VV000000000T0000000V000P000000000000011111
11MP00000T0T0000000P0000000M000000000D00P0000000000MVV00V000T0T000M0000V00000T0D00VM0010D0011000011111
111111110000000000000110111100PM011011V0001111B1100000000101111111100T0P00000000M000001000011T00011111
1111111101011010000001101111T000011D110BP01111011T0000000000D000000000000000000000B0111000P11000011111
11111111010100B0000000000000DP000T00000D00000000V0000000000T0B00000DP000B000V000011V111000011110011111
111111100T000000000000D000MB00V00V000P00000000TD0M0000000000000T00000000000V0000V0P000000001111B011111
11111110V000000000000D001111000M01101111011111011000000V010111111110000T0M011111111011100M011110011111
111111100000B00V00D00000T00DD0000000000D000000P00000000000000000D0D0000DV000000000M000B000000000011111
111111100000P00M00T000V11111111011101000B00011011000B00001011111111110000000000000000T000000V000011111
1111111P00V0D000P00000011111111M111010000000110110000T00D101111111111111100V0011110T000000111110011111
11111110D0000000000000000V0D1110111B1000P000110111101B000000000000000000V0000000TB000T000000D110011111
11111110B000101000P0000000M0000000000000011111000010111111011111111111111B0000111100P0000011111B011111
111111100P001010110000000000000000000000T0000000M0000P0000T00000000000000000000000000000D011111PV11111
11111111010000000000000D000000000000011101111100T0101111110111111111111110T00P1111V00000VP11111P011111
111111110101101011T00000000000T0011011110111110000100T00000111111111111111011011110000000P111000M01111
1111111101011010110000000000M00001101111011111T00D100000P00111111111111111011111110B000P00111000001111
11111111M1011010110000000000000D01101111011111000T1000000001111111111111110111111100D00000111000001111
111111110101101011B00000000TM0000D0M000000B00000VP000M000D000MD000000000PT00000M000000000D011000001111
111111110101101V11000001100000V0000M0000D000BM0000000P00000000000000000D000000M0000000000001100B001111
1111V0D0000010101110100DP0000000000M0111011111D111100T0D000111111111111110000000000D000000011000001111
1111P00000001D10111T11111111111111111111011000T0111011111TV00000111111111000D0VP00T0000B0001110P011111
111100000P001010111011100BMD0B00000P0000V0000000000000DT0V000000000000000M00000000000V0D0M011100011111
11110DD0000P101P1110111VV0000P0011111111011000001110111111000000100D0MV000000000000000001111110P011111
11110B000000101D111011100000T0001000000000000000000000B0000000P00B000000000000111111111011111100011111
111100000000100T000000V0000000000D0000B00DB000000B0000M00M00011111111111100001111111111011111100011111
11110000000T000000000000000000000000V00D0M000E000T00000000000P00000000000000000000000000000D000M011111
111100000M00111000000010000P0D000M00M00000000M0P00B000000D00000000000000000001100001111011111100000011
111100T000001110V0B00D000000D00000T00000000011T11110111111011111111111000001111000011110111111000BM011
111100000111111000B00010B00000M01111111111111101111011111101111111111100000111100001111011111100000011
111100B0011111100000000PM00V0000000000B000000000000000000000000000B0V00000D0000P000001101111110B000B11
111100B00111111M111M1111111111111111111111111101111011111101110BV00000000001111D000111000001110000B011
11110M000111111011101111111111111111111000M011011110111111011100V00M0P00000111100000000D00M00000000011
11110T0P00V0000000B0B00000000000MT000000000000000B00000D0000000TTB0B0M0B0M00P000000PB00000000000001111
1111000011111110100V0T1111111111100V00000V0T0000000000D0000000000000000B110111111111110000011101111111
1111V0001111111000000000000000P0000000000D000000000B0P0TM00000M0000000T000M011111111110T00011101111111
11110000000V0000000000T00000P0000000000000000000B00000000T00000T00T000V000000000P00000000M000D00111111
1111P0000B01111110M0001111100000MD1111100V001111111110000111111111111111000D11111111110M00011101111111
111100B00001111110000P11111T0000001111100P001111111110000111111111111111000011111111110000011101111111
111100B0M001111110000B11111B0000P011111000001111TB00000011111111111111110B0011111111110000011101111111
1111B00000011111100000111110BB000011111000000P000V0000000000000000B0000000000T00P000000B0T011101111111
11111111111111111000001PV00000000000V00T0111111111111111VV0001111111111100T011111111111011111101111111
110000000000000000B000D00M000T0000V0000000000PP0000000000000T0V000M0000000000P00B000000000000001111111
110000V111111111111111111110000000111111111111111100000000000111100D00D0111111111111111111111111111111
1100V00111111111111111111110P00P001111111111111111000T00000001111B0T0000111111111111111111111111111111
110000D1111111111111111111100000001111111111111111000VL00000P11110000TV0111111111111111111111111111111
11P00M011111111111111000000D001111111111111111111111111000V0D0000000000000000T000000000000B00111111111
1100T001111111111111111111111111111111111111111111111111111100000T0B0111111111111111111111111111111111
11111000000D0T00T00000000000000D00000000V00000D0000D0M0000B00V0B00000000000T0000000D00000T000111111111
111111111111111111111111111111111111111111111111111111111111111111111111111111111111111111111111111111
