NO ./textures/STONE3.png
SO ./textures/STONE3.png
WE ./textures/STONE2.png
EA ./textures/STONE2.png
C 225,30,122
F 220,100,3

111111111111111111111111111111111111111111111111111111111111111111111111111111111111111111111111111111
111111111111111111111111111111111111111111111111111111111111111111111111111111111111111111000000011111
111111111111111111111111111110000011111111111111111111111111111111111111111111111111111111000000011111
111V0000000T1111110000B0011110D0001111111111111111111111111111111111111111111111111111111100EB00B11111
11100VB00000111111B00000011110000011111111111111111111111110000001111111111111111111111111000T00011111
1110000000001111110000T0011110P0M01111111111111B000VD0T11110000001111111111111111111111111000000011111
11100000000011111100000001111MM00011111100000000000M0T011110000001111111111111111111111111VV0000011111
1110M000000011111111M000000000111111111100000000000000011110000001111111111111111111111111000000011111
11100000MD001111111100000000111111111111B0000T00000000011110MT0001111111111111111111111110000111111111
111111D111111111111100000000111111111111V00D000B0T0000000000000001111111111111111110000010DV0111111111
1111110111111B0B000000000000111111111111TV000000000000011111111111111111111111111110000010000111111111
11111100000000M000000M000000000000000000P00DB00000000D0V0T0000B0000000D000000011111000001M000111111111
111111111111100M000M11M000000T0000T000000T00000011111111111111111111T0001000001111100T0M100D0111111111
1111111111111B0V0000110111111110T00M00000D00000011111111111111111111000010000011111000B010T00111111111
11100D00V01110000T0011T11111111000000000V0000V0V1111111111111111111100001000V01111111011111B0111111111
1110000P001110000B00110111111110PT00000T110111101111111111111111111100001V0000111111100V00000011111111
1110M00000111D000P0011T111111110TVT000001101111D100000000111111111110000100000111111100000B00D11111111
111M0000T0111110111111V1111111100000000B11011110100D0000011111111111MMD01000001111111M0000000011111111
111T0000001111101111P000000B0000000000BDP0000000M000M000M00000000000M0D00P000D100001100000000011111111
11100M0000111100B00PB0T00D000PT000T00000000B000T000000000M00D000000M000000M000000T0000000T100111111111
11100000001111000000010111111111111P11111101111M1000000001111111111110110D00V01D0000000011100111111111
11100M000011110000B001011111111111101111110111101111110100000100000110110000D0100B0000001110010B000011
111111111M000B000B0000000P000000000000000000000000000P0000000T00000000000000000000V0000011100100000011
1111111111111100000001B11111100000001000000B111B111111010000D100000110110000001000011010111001P0M0D011
11111111111111000000M101111110T0000010000000111011111101000001000T0110110000000000111010111BB100000011
1111111111111100000001011111100000001000000V111011111101000001000001101100000M0000B0000011100111011111
1111111111111110D00D000000T00000111011110001111011110000BV00010000011M11100000111110000D111DT111011111
11111111M0000000111111011000000011101111110111101111PP00000V00M111111T111000D011111000001110T111011111
111111110P00000V111111011B00000011101111110111101111000000000MBT01111011100D00111110B00011100111011111
11111111VM00000011111101100000001110111111B1111011110B0000000000011110111T00001111100000111000000D1111
11111111000000PD111111P110000T00111011110000B0V00M00MPD10TP000T001111011110111111110000011100000001111
111111111111111P111111011M00000011101111110111B0000111010V00000001111T11110111111111B01011100000001111
111111111111111011111101100D0MB011101111110111TP0001M000V111B111111110111101111111110P1011100000001111
1111111111111T00000000P0000V0M0000000P00D000000P00010V000111T111T000MD11110111111111001011100P000T1111
1111111111111000000011111M111011M00000001101110000V10000011101110T000011110111111111001011100000001111
11111111111110MD00001111101110110000000M1101110000B100000111011100000011110P0T0000110010111VP00P001111
111111111111100B000011111011101100B0000V0P0001V000P100BP0111011100000P111100T000001100101110V101011111
111111111111100D0000111110111011000000000000010000B10B0P0111B111000000111100V0P00V11T0101110T101B11111
11111111111110000T0011111D00000000M0000000D0M0000D0000000MV0000000000000000000000000000000000101011111
11111111111110000000111110000D1100D0M00000M0010000011101V000001100000000000000000000000000000001011111
111110T00000000000000B000000T011V00VD0B01101T100000B0000000P000V00000M000000DT000V11D01V111V1111P11111
11111000011110B0T0001111100T011111101111110101111101110100000011011110000000000D00110010111M1111M11111
11111000011111000D0000T00P0M0M0B111011110DT000000P0D0V0000000P0000000000000M00000000000000000D11011111
111110V0011111100001111110T001111110000M00M000000000D000VP000D1101111P0000M1111111110V1010000B11011111
1111100001111110T00111111000011111100000000101111111110101110000M00T100000011111111100101P000D11011111
1111100V01111110000100V00T000111111000000001011111100000B0B00BD000000000000111111111001010000011011111
111110B0011111100B01111110111111111000V00001V1111110000B01110V00000011000000000000M000101000D011011111
11111T00D1111110V11111000P01111111100000000101111110000001110000000011011110P0000M00001010P0D011D11111
1111110111111110011111000001111111100000P0B101111110000D01110000T00P11011110T0000V0V00101000T011011111
111111M111111110011111B00001111111100000D001011111100T0MB111B000PB001101111000000M000M1010P00D11011111
111111011P00M00000000V00000000000V00000000000T0000000000000P000000000M000D0001111111001010000011011111
1111110000000000000000000T00000M0B00111111010000011M000001110011V11111011111111111110010110P1111011111
111111000000B0000000V0000000000000T000000000000000000V000V00000P00P000V0000D00000000000001001111011111
11111100000PV00010000000011111111111111111010B0T0111100M000B00110111110000000V011111DV1B11V01111011111
1111110000000000100BP011111111111111111111010000011110000000001101111100000000T11111001011PV1111011111
111111000000000010111111111111111111111111010B0001111000TPB0001101111100T0P000011111001011001111011111
11111101111111101011111111111111111111111101M0V0V11110M0T000001101000000T00000T11111001B110D1111011111
111111011111111T1B1111111111111110000000000T000D0000000V0000D0000T00000000000000B0000000D0001111011111
11111101111111101T1111111111111110000000000000000000000P0000000V00000T00000T00D000T00000000000D0011111
11111000B11111101B11111111111111100000B000000P0001111000000P001101T00000T0B000011111001000000D00011111
111110D00000000000T0000000B00000T000P000PB0000000B0000000D0V00000000000D00000000000VD0P000000000011111
11111MP0011111101B0D00D10000111110000000M0100000000001T1000000000111P11111111111111100110B00000B011111
11111000011111101000000100001111100D0000000B000P000000000000B000000000000T000000000D000001101111011111
1111100PV100PB00V00000010000111111000000V010M0P00000M10100000000000V000B00000000000000M001101111D11111
111110T001000000M000000100DD1111110000000010V00B000P01T10000000001110111111111111110P00001000000000111
11111000010D0000000000010B0M11111100000D00100D0TM0P0D10100000V000111011111111111111V000001000000B00111
111110D0010000000000T0000P011111110000BM001000000000000000000T0000000011111111111110B00M010000B0000111
1111111111111000T0000000000000000D0T000D00000000000B000000000000000M000P000000000000DM0001000000000111
1111111111000000TV0M00000V00000000B000M000000000000MD00M00D00000000000000000M00D00000000000000M0011111
1111111111000000000000000M01111111D0000P00110111101111B111111011P0000111000011111100P00001101111111111
1111111111V0000000000000B00111000000000000110111101111011111101100V001110B00111111D00000011D1111111111
111111111100000000P0000000011100P00111110000000V0M1111011111101100000111000011111100000DP1101111000D11
111111111100000000000000T0011100000111110000000000111101111110110000D111000011111100000001101111D00011
111111111111111000BD00BB000000000V000000MPB00000000V000000M0000B00010111000011111100000001101111D00011
1111100001111110101111101111110000011111V0000000V011110000000001011101110000111111000000V1101111000011
111110000111111010111110111111000000000000000000000000000T0000T0VM0000D0P00000B00T000V00V000P000001111
111110000111111V101111101111111000000000000MVM00B00D000000000T0000000001111011111110101110BB0011111111
11111P00D1111110101111101111111111011111110000111011110B000000010111B111111T1111111M101110000011111111
11111D0D0111111P10111110111111000D0V0000000000BM0000000000P0000T000MB00000000000011010111B0T0011111111
111110B0011111101D111110111111000001111111111111101111000000M001M1110111110MPL00011D1011100M0011111111
1111100000P00T000T000D00V0D111000001111111111111101111T00000101101110111110000P0T110101110000011111111
10000000111111000000111V0001110D0P011111111111111011110111111V11011101111100B000000T00V00V001111111111
1000V000111111D0000011100M0111000001111111111111101111T111111011011101111100000001101011111T1111111111
1000PBVB11111100000011100D0V0000000M0V00000T000000000000000M000000000000000DP0000110101111101111111111
1MB0P0001111110000001110BP0000B00T0000001111111110111101111110110111V11111111100D000001111101111111111
100P00001111111M000000000000000000011111111111111011110000T00T0M000000000111110000000D1111101111111111
100000001111111010111110111111000TT11111111111111011111111111011111100000111110T0000001111101111111111
1111000000D00000000D0000000000011101111111111111101111110B0000001111000V011111V00B00001111101000000B11
111111100001111D1010T0000111111111000000B00000000000000000000000000P0000000000000000000000001T00000M11
11111110000111101D1000000111111111111111111111100PB000110000V000111100000111110V000T001000B01000000011
11111110000111101V10V0000111111111111111111111100000B011T0T0000T111100B0011111B0B00D001000M01000000M11
1111111000M1111010100B0T00000B00111111111111111000000011B0000000111101000001110000000010D00D10P0D0P011
111111100001111010000000P000M000000P0000P00V0000000000V0P0000000000VT000000B00000000T00B11101000000011
1111111000B1111010TVT0000000P00000000D000D00000P0000MM00000000P000V0000000D00D00000D0000011B1000000011
1111111000B111100000000P00D0000M0000MD0000000M000000000000P0000T0000VV00M0000T0V0000000MD00000D0000011
1111111000P11111111000000000000V11111111111111111011111110000V0000000000000000TM000000D0000000MB111111
10T00T0000000000D0000000000000M00000000000TD000VM00M000DM00000T000000P0000P0B00V00000P1110000111111111
1000T00100V00000B0D0T0000000T00000000000000V000000000DT00000M0000M0000000B0000000P0011111P000111111111
10000001111111111111100000P000111111111111111111111111111110000M000T001111111000000M11111M0T0111111111
10000001111111111111111111111111111111111111111111111110000T0000000V000B000T00000D00111110000111111111
1100000VT000M000V000000000000M00B0000000000M000V00000B0D000000000000T0000000000000T000T000111111111111
111111111111111111111111111111111111111111111111111111111111111111111111111111111111111111111111111111